#######
#.....#
#.xo..#
#.p...#
#.....#
#######