  ####
###..##
#...p.#
#.#..o#
#.#o.x#
#..x..#
##...##
 #####