#######
#.....#
#.xo..#
#.p...#
#...ox#
#######