..####.
###..##
#.....#
#.#..p#
#.#o.x#
#..xo.#
##...##
.#####.